{
"width": 15,
"height" : 17,
"map":[
["I","I","I","I","I","I","I","I","I","I","I","I","I","I","I"],
["I","X","W","X","X","T2","W","E","W","T2","X","X","X","X","I"],
["I","X","X","X","X","X","W","W","W","X","X","X","X","X","I"],
["I","W","X","W","X","X","X","X","X","X","X","X","S","W","I"],
["I","R","X","R","R","X","X","W","X","X","X","X","X","X","I"],
["I","X","X","X","R","X","X","S","X","X","W","W","X","X","I"],
["I","X","X","X","R","W","X","X","X","X","S","X","X","X","I"],
["I","X","W","X","R","W","X","X","X","X","X","X","X","W","I"],
["I","X","S","X","R","R","R","X","R","R","R","X","S","X","I"],
["I","W","X","X","X","X","X","X","X","W","R","X","W","X","I"],
["I","X","X","X","S","X","X","X","X","W","R","X","X","X","I"],
["I","X","X","W","W","F","X","S","X","X","R","X","X","X","I"],
["I","X","X","X","X","X","X","W","X","X","R","R","X","R","I"],
["I","W","S","X","X","X","X","X","X","X","X","W","X","W","I"],
["I","X","X","X","X","X","W","W","W","X","X","X","X","X","I"],
["I","X","X","X","X","T1","W","B","W","T1","X","X","W","X","I"],
["I","I","I","I","I","I","I","I","I","I","I","I","I","I","I"]
]

}
